 #   # #     # #     #   #       #     
 # # # # # ### ##### # ######### ##### 
   #   # #   #   #         #           
 # # ### ##### # # ######### ##########
 # #         # # #         #     #     
## # # ##### # ##### ##### # ### # # # 
   # # #     #     # #     # # #   # # 
 ### ### # ### ######### # ### # ### ##
 #   #   #           # # # #   # #     
 ### ######### ##### # # ##### # ##### 
 #     #   #     #       #   #     # # 
 ######### # ########### # # # # ### ##
       #         #         #   # # #   
 # ### ##### ##### ### ####### ### # ##
 # #   #       #   #   #   # #         
#################### ### ### ### ### # 
 #         # #   # #   #     # # #   # 
 ### ### # # ### # ### ### ### # ######
     #   # # #       # # #   # #     # 
## # ### # # # # ##### # # ### ### ### 
   # #   # # # #   # #     # #         
 # ### # ### ##### # ##### # ##### ### 
 #   # #             #   #   #     # # 
 ### ### # # ### ### ### ### ##### # ##
 #     # # # #   #     #       #     # 
## ######### ### ##### # # ### # # ### 
       #       # #   #   # # # # #     
## ### # ### ##### # # ##### ####### # 
   #   #   # #     #         #       # 
