 #   #   #           # #     # #   #   
 ### # ##### # # ### # ##### # ### # # 
 #       #   # # #   # # #           # 
 # ### ####### ####### # ##### ### ### 
 # #                 #       # #   #   
 # ####### # ####### # ######### ##### 
   # #     # #   #       #           # 
#### ######### # # # ### # ##### # ####
     #     # # #   #   #   #   # # #   
## # # # ### ############# # ##### # # 
   # # # #             # # #   #     # 
#### ### # ### # # ##### # ### ### ####
   # # # # # # # #   #           # #   
 ### # # # # ### ##### ### ##### # ### 
   #       # #   #     #   #     #     
## # ### # # # # ##### # ####### ### # 
       # #   # #   #   #   #     # # # 
#### ##### ##### ####### ### # # # # ##
 #       #   # # #       # # # #   #   
 ##### ### # # # ### ##### # # ##### # 
 #       # #   # #   #   # # # # # # # 
 # ##### ### # ######### # # ### # ####
     #     # # #                 #     
 ### # # ##### ### ##### ### ### # # # 
 #   # #   # #     # #   # #   #   # # 
 ### ####### ### ### ### # ####### # ##
   #     #           # # #         #   
 ### ######### ### ### ### ####### # ##
 #       #       #       #   #     #   
