 #     #     # #   # #   #         #   
 # ### ##### # ### # # # # ##### ### # 
 # #       #   # #     #       #     # 
 ### ####### ### ##### ####### ### # ##
 #           #     #   # # # #   # # # 
 ####### ### ### ####### # # # ### ### 
       # #     #     #     #   # #     
###### # # ### ##### # # ### # # ### ##
     # # #   #     #   #   # # #   #   
## ### # # ### ### ##### ##### # ##### 
         # # # #   #           #   # # 
 ####### # # # # ### ######### # ### ##
 #       # #   # #         #       #   
######## ### # # # ##### # # ######### 
 #   #   # # # # # #   # # # #   # # # 
 # ##### # ##### ### # ### # # ### # # 
         #     #   # #     #       #   
## # # ### # # # # ####### # # ####### 
 # # # #   # #   # #       # #   # # # 
 ### ##### # ### ### # ### ### ### # # 
 # #     # # #       #   # #     #     
 # # ### ### # # ####### ### ### # # ##
     #   # # # # #   #   #     #   #   
#### ##### # ### # # ### ##### ##### ##
   # #         # # # #     # #   #     
 # # ##### ##### ### # ##### ### # ### 
 #   #     # #       #   #   # # #   # 
 # # ### ### # ### ##### # ### # ### ##
 # #   # #       #   #         # #     
