 #             #       # # #   #       
 ####### ### ####### ### # ### ####### 
         #   #                 #   # # 
######## ########### # ### ####### # # 
   # #         #     #   #     # #     
 # # ####### ##### ####### ##### # ####
 #       # # # # #   #         # # #   
## ####### # # # # ####### # ### # # ##
           #     #       # #   #       
## # ### # # ### # # ########### ### # 
   # #   # #   #   #   #   #   # #   # 
#### ### ##### ### # ### ##### # ######
   #   #       #   # #         #   #   
 ### ### ####### # ######### ##### # # 
 #   #   # #   # #   #   # #         # 
 ### # ### # # ### ##### # ####### ####
     # # #   # # # #     #           # 
#### # # # # # # # ### ### ######### # 
 #   #     # #   # # #     # #   # #   
 # ############### # ##### # # ### # ##
 #             #   # #   # # # # #     
 # ### # # ### ### # # ### # # # ######
 # #   # # # #   # # # # #             
 # ### # ### # ### # # # # ############
 #   # # #   #   #   #           #     
 # ### ### # ####### # ####### ####### 
     #     #       #     # #   #       
#### ### # ### ##### ##### # # # ######
       # # #       #   #     #         
