     #   #   # #         # #   # # #   
 ### ### # # # # ######### # # # # ### 
 #   # # # #       #   #     #     #   
 ##### # ##### # ##### ### ##### ##### 
               # # # #     # # #   #   
 ########### ### # # # # # # # # ### # 
     #   # #   # #     # # # #   #   # 
#### # # # # # # ### # # ### # ##### # 
     # # # # # # #   # # # # # # #   # 
######## # # # # # # ### # # # # # # ##
     #       # # # #   #     #   # #   
## # ##### # ##### # ##### # ### # # ##
   # #   # # #   # # # # # #   #   # # 
 ### # # ### ### ### # # # ### ##### # 
   #   #           # #   # #     # #   
 # # # ##### # ##### ### ### # # # # ##
 # # #   # # #     #   # #   # # #     
######## # ####### ### # ##### ########
       #   #   #   # #     #       # # 
#### # # # ### ##### # ##### ##### # # 
     # # # # #     # #     #   #   # # 
## # ### ### # ##### # ####### ##### # 
   #     #   # #   # # #   # #         
 ########### # # # # # # ### ####### ##
 # #   #   #     #       # #     # #   
 # # # # # ##### ### ##### # ### # # ##
   # # # #   # #   #   #   # # # # #   
 # ### ### # # # # ### ### # # # # ### 
 #         #     # #           #     # 
