 #       # #         #   #   # # #   # 
 # # ##### ### # ### # ### ### # # # # 
   # # # #     # #   #   #   # # # #   
 ##### # # # ##### # ### # ### # ### ##
   # #     #     # # # #     #         
 # # # ### ### ####### ##### # ##### ##
 #     # #   #   #   # #     #   # #   
###### # ### ### ### # # ##### ### # ##
 #       # # #   #   # # #   #   # # # 
 # # ##### ### ##### # # # ### # # # # 
   #       # # # #       #     # # # # 
## ##### ### ### # ##### ##### ### ### 
   #   #   # #         #     #       # 
#### # # ### # ####### # # ####### # # 
   # #     #   # # # # # #         #   
 ### ### ##### # # # ##### ### ### # # 
   # # #   #   #     # #   # # #   # # 
## ### ### # ### # ### ##### ### # # # 
           #     #         # # # # # # 
 # ### # ######### ######### # # ######
 # #   # #   #   # #         #     #   
 ####### ### ### # ### # ##### ### ### 
   #   # #       #     # #       # #   
## ### # ##### ##### # ### ##### # # ##
   # #         #     #   # #     #     
 ### ### ##### ### # ### # ### # # ####
 #     # #   #     # #   # # # # #     
## # ##### ### ### # ####### ##### ####
   #             # #           #       
