   # # # #       # # #           #   # 
 ### # # ####### # # ### ##### # ### # 
 #   #   #     #       # #     # # # # 
 ### # ### # ### ### ######### # # # # 
 #   #   # #   #   # # #     # #       
 ### # ### ### ### ### ##### # # ### ##
             # #     # #       # #     
 ### # # ##### ### ### ####### ####### 
   # # # #         #     # # #   #   # 
## # # ######### # # # ### # ### ### ##
   # # #     # # #   # #   #         # 
###### ### ### # # ### # ####### ##### 
   #   # #     # #   #   #   #       # 
## ### # # # ### ### ### # ####### # # 
 #   #   # # #     #   # #       # #   
 # ####### ### # # ##### # ### # ### # 
     #   #   # # # #       # # # #   # 
 # ### # # # # ### # ##### # # # ### # 
 # # # # # #     # # #       # #     # 
 ### # ### # ########### ### ####### # 
   # # # # #   # # #   #   # # #   # # 
 ### # # ### ### # # ### ### # # ### ##
   #           #   #   # #   #     #   
 ### ### ##### ### ### ### ### # # # # 
     #   # #       # # # #   # # # # # 
 ### ### # # ##### # # # ##### ### # ##
 # # #   #     #         #   # #       
 # ####### ### ### ##### ### ### # ####
 #         #   #       # #       #     
