     # #     #   # #       # 
## ### ##### # # # ##### ### 
   #     #     #             
## ##### # ### ##### ##### ##
       #   #   #       # #   
 # # ### ##### # ##### # ### 
 # #     #     #     #   #   
## ### # # ### ####### ######
 # #   # #   #   # # #       
 # ##### ####### # # ### ### 
 # #     #     # # #     #   
 ##### ####### ### # ####### 
   # #     # #   #     #     
 ### # ##### # # ### ####### 
 #       #     # # #   #     
 # # # # ##### ### # ####### 
   # # # # #     #     #   # 
###### ### ### ##### ##### ##
           #                 
