       #   #     #   # #   #     #   # 
 # ### ### ### # # ### # ##### # ### # 
 #   # #     # #       #   #   # #     
###### # ########### # # ##### ### ### 
         #         # # # #   #   # #   
 # ### # # # ######### # # ### # ##### 
 #   # # # # # # # #           #       
#### # ##### # # # ##### # # ### # # # 
     #     #       # #   # #   # # # # 
## ########### # ### ### ########### # 
   #       #   #     #   #     #     # 
## ### ##### ####### # # # ### ##### # 
     #   #     #       # # #     #   # 
## # # ####### # ####### # ### # ##### 
 # #           #       # #   # # # # # 
 # ### ####### ########### # ### # # ##
     #       # #           # #   #     
## ####### # ##### ##### # ### # # # ##
       #   #     # #   # #   # # # # # 
## ### # ##### ##### # # ####### # ### 
     # # #       #   #   #     #   #   
 # ### ##### # # # ### # # ##### ##### 
 # # # # #   # #   # # #       #       
 ### # # # # ####### # ### # ### # ####
   # # #   #   #     #   # #   # #     
## # # # ##### ##### ### ### # # ### ##
   #   #   #   # #     # #   # #   # # 
 # # ##### ### # ### # ### # # ####### 
 # #   #     #       #   # # #         
