 #             #   #       #     # #   
 ### ####### ### ### ####### ### # ### 
     # #         #   #     #   #   #   
###### # # ##### ### ##### ### ### # # 
     #   # #       #     # #     # # # 
 ######### ##### ### ##### ####### # # 
       #   #       # # #       #     # 
 ##### ### ### # ### # ### # ##### # ##
 #   #     # # # #       # # #     #   
 ### ##### # ########### # ####### # ##
 #   #         #   #               #   
 ### # ##### # # # # # # ##### # # ### 
 #   #     # # # #   # # # # # # # # # 
## ### # ### # # ### # ### # # ##### ##
 #     # # # #     # #     #       #   
 # # # ### # ### ### ### # ### ### # ##
   # # # # #   # #   # # # # # #       
 ### ### # # ####### # ##### ### ##### 
 #   # #   #   #         # #   # # # # 
 # # # # ### # ##### # # # ### ### # ##
 # #     # # # # # # # #         # #   
#### ##### ### # # ####### # # ### # ##
 #   #   #   #     #   #   # #     #   
 ### # ##### ### ##### ### ##### # # ##
 #   #           #     # #   # # #   # 
 ### ####### ####### # # # ### ### ### 
 #   #   #   #     # # #       #       
 # ### # # # # # ##### # ##### # # ### 
     # #   #   #     #       # # #   # 
