 # #       # #   #       #     #   #   
 # # # # # # # ### ### ##### # # # ### 
   # # # # # # #   # #       #   # #   
## ##### ### # ### # ### ######### ### 
 #           # #     #       # # #     
 ### ####### # # # ##### ##### # # ####
         # #     # #   #   #   #       
###### # # ##### # # ##### ### ### ####
 # #   #   #     # #   #   #         # 
 # ### ########### # ### ### # ### ### 
           #   #     #   # # # #       
## ########### ### ### # # ##### ##### 
     #   #     #     # # #   #   #   # 
## ### ##### ##### ######### # # ### # 
   #               #   # # # # #     # 
 ### ####### ### # ### # # # # ########
 #   #   #   #   # #       # #         
######## # ##### ### # # # # # ##### ##
 #   # #   #         # # # #   #       
 # # # ######### ### ####### ##########
   #   #       # #     # #     # #   # 
 ### ### # ### # ##### # ### ### # # # 
 #       # # #   #       #   #     #   
############ # ##### # # ### # ##### ##
 #   #           # # # #   #     # #   
 ### # ##### ##### ####### # ##### # ##
   # #   # #     #   #     #   # #     
## # ### # # # ##### # ### # ### # ### 
         #   #     #   #   #   #     # 
