 #     #         # #     #         #   
 ##### # ##### ### ##### ####### # ### 
 #       #       #   # #     #   #     
 ### ### # ### ##### # # ##### ########
       # # #     # #           #       
## ### ########### ##### ##### # ######
 #   #   #     # #           #       # 
 # ### # ### ### ### ### ### ### ### # 
     # #       # #     #   # # #   #   
######## # # ### # ### # ##### # ######
     # # # #   #     # #   #   #       
## ### # ### ##### # ### ### ####### ##
     #   # #     # #   #   #     #     
## ##### # # # ### ##### ####### # # ##
       # #   #   # #   #     #     #   
 ##### # # # ######### # # ######### ##
     # # # #             #   # # #   # 
 # ### ####### ##### ##### ### # ### # 
 # #     #   #     # # #         #   # 
## ####### # ### # ### ##### ### # # # 
         # #     # # #     # # # # # # 
## # ######### ### # # ##### # # # ### 
 # # #   # #   #     # #   # #   #     
 # ### # # # ##### # # # # # ##### # ##
 # #   #   #   #   # # # #   #     #   
 # ### ### # ######### # ##### # ##### 
 #   # # #           # #   #   #   #   
 # # # # ### # ### # # ##### ######### 
   #       # # #   #       #       #   
