       # # #   #     #       #   #   # 
## ##### # # # ### # ####### # # # ### 
   # #   #   #   # #           #   #   
 ### ### # # # ############# ####### # 
       #   # #   #   #   #   #       # 
## ####### ######### # ##### ### ##### 
 #   # # #   #         #     # #   #   
 # ### # # ### ######### ### # ####### 
         #   #     # # #   #   # # #   
## ##### ### # ### # # ### ### # # # # 
     #       #   # #         #     # # 
## ######### # ############# ##### # # 
 # # #   #       #   #   # #   # #   # 
 ### # ### ### ##### # ### # ### # # # 
     #   # #   #   # # # #     #   # # 
## # # ####### # ### # # ### # ########
   #   # # #       # #     # # #   #   
 ### # # # # # ### # # ##### ### ### ##
 #   #     # # #     #   #   #   #   # 
## ### ##### ##### ### ### # ### # ### 
     #         #     # #   #           
#### ########### ##### ### ### ##### ##
 # #   # #   # # #     #   #   # #     
 # # ### # ### # # ### # ####### ### # 
 #     # # #         # # # #         # 
 ### # # # # # # ######### ### # # # ##
     #     # # # #           # # # # # 
 ##### ### ##### # ######### # ### # # 
   #     #     #         #     #   #   
