   #   #   # # #   #               #   
## # ### ### # # ### ##### ### ### ### 
     #   #   #     #     # #   #       
 ####### ### # ############# # ### # ##
 #   # #       #   #         # # # #   
 # ### ### ### # ### # ### # ### # ####
   #       # # #   # #   # # #   #     
 ######### # # # ### # ##### ### # ####
 #         #   # #   # # #     #   #   
 ### # ####### # ### ### ####### ### ##
 # # #     #   # # # #     #   # #   # 
 # ### ####### # # ### ##### ### # ### 
     # # #         # # #   # #         
 ####### ####### # # # # # # ####### ##
     #     #   # # # # # #     # #   # 
#### ##### ### # ### # ### # # # # # # 
 # #     # #         #     # #     #   
 # # ### # ##### # ######### # # ######
 # # #     #     #     #   # # #       
 # ##### ##### ####### # ### # ##### # 
 #   # # #         #   # # # #     # # 
 ### # # # # ##### # ### # # ### # ####
     #     #     # #     # # # # # #   
 # ### ### ##### ### ##### ### # ### ##
 #     #   #     # # #                 
 ##### # # # ##### ### ### # ####### # 
     # # # # #           # #     # # # 
 ##### ##### # ### ### ##### # # # ### 
     # #         # #       # # #     # 
