 #     # #     #     #       #         
 # ### # # ##### # ####### ##### # ####
 #   # #       # # #             #   # 
 # ##### ####### ### ########### # ### 
   #       #   #   #       # #   # #   
## ####### # # # ### ####### # ### # ##
   #     # # #         #     #   #   # 
 # ##### # ### # # ##### ### ####### # 
 #             # #   #   #     #   # # 
## # ### ### ####### ####### ##### # # 
   #   #   #   #         # #   #       
 # # # ##### ####### ##### # ##### ####
 # # #   # #   #   #           # #   # 
## # # ### # # # ##### # # ### # ##### 
   # #   #   # #   # # # #   #   #     
## ### # ##### # ### # ##### ####### ##
   # # # # # #     # # # #     #       
 ### ### # # ### # # # # ######### ### 
 # #       #     # #     #       #   # 
 # ##### ############# ### ### # # # ##
 # #       #   #   #   # #   # # # #   
## # ####### # # ##### # # ### # # # # 
     # #     #               # #   # # 
## # # ### ########### # # # # ### # # 
   #     #   #   #   # # # # # # # # # 
 # # ##### # ### ### ### ##### # ### ##
 # #     # # #     #   #     # #       
 ##### ####### # # # # # ### ### # # # 
 #       #     # #   #   #     # # # # 
