       #   #   #     #       # #       
## ### # ##### # ### # ### # # # ### ##
   #     #   #     #     # # #   #     
 ##### ##### ### ####### ### ####### # 
 #                 # # # #     #   # # 
## # ##### # ####### # ##### ### ##### 
   # # # # #   # # # # # #     #   #   
 ### # # ### ### # # # # ### ##### # # 
 #   #   #   # #     #   #   #       # 
## ### # # # # # ####### ######### ### 
   #   #   # # #     #   #     # #   # 
 ### ### ##### # ### ### ##### # ##### 
 #   #           # # #   #   #   #     
 ####### ##### # # # ### # ### ##### ##
 #           # # # #   #     #         
######## ####### # # ### # ####### ### 
           #   #   #     #   #     #   
 ######### ### # ### # ### ####### ### 
 #           #   # # # #   #         # 
## ############# # ####### # ### ### ##
             # #     #   #     # # #   
## ### # ### # # # ### ### # # ### # # 
   # # # #   #   #   # #   # # # #   # 
 ### # ##### ### # ### # ####### ##### 
 #   #   # # #   # #       #         # 
## ### ### ### ##### ##### # ### # ####
   #   #   #   # #   #   #   #   # #   
 # # # # # ### # ##### ### # # # # # ##
 #   # # #         #       # # # #     
