 #     # # #     #   #               # 
 ##### # # ### # # ##### ##### # # ### 
 #         # # # #       #   # # #     
 ####### # # # # # ######### ##### ####
     #   #   # #   #   #   #     # #   
 ######### # ##### # ##### # ### ### # 
       # # #   # #   #       #     # # 
## ##### # ### # ### # ##### ######### 
   #         #   # #   #   #     #     
## ### # ######### ### # ####### ### ##
       #     #   #       # #         # 
 # # ####### # ### ### ### # # # # # # 
 # #   # #       #   # # #   # # # # # 
 # # ### ####### ### # # ####### ### # 
 # #     #       #   # #   # #   #   # 
## ### ### # # # # ### # ### ####### # 
 #   #   # # # #   # # #           #   
 # ##### ### # ##### # # ####### ######
   # #     # #     # #       #         
#### # # ####### # # ##### ##### ### ##
   #   # # #     # #   #       # #     
## ### ### ### ##### ##### ### # ##### 
     #       # #           #   # # #   
 ##### ### ##### # # # # # ##### # # ##
 # #   #     # # # # # # #   #     #   
 # # ####### # ##### ##### ### # ######
       # # #     #   # #     # #       
## # ### # # ######### # # # # # ### # 
   # #                 # # # # #   # # 
