       # #       # #   #               
 # ### # ### # ### ### # # ### # ##### 
 # #     #   # #         # #   #   #   
 ### ### # ####### # ##### # ####### ##
 #   #   #       # # #   # # # #   #   
###### ##### ####### # # ### # ### # ##
 #     # #     #     # # #     #   #   
 ### ### ##### ### # # ########### # # 
 #     #     #     # #     # # # # # # 
 # ### ### ##### ##### ### # # # # # ##
   #   #   #   #         # # # #       
 ##### # ### ####### ####### # ##### ##
   #   #   #   #   # # #     # #       
 # ### ### # ##### ### ### ### ### ### 
 # # #   #   #   #       #           # 
 ### ### # ### ##### ####### # ### ### 
 # #     #         # # # #   # # # # # 
 # ### ### ### # ### # # ### # # ### # 
 #     # # #   #     # #     #     # # 
 ### # # # ### ##### # ##### ### # # ##
   # # #   #   #             # # #     
 # # # # ##### ############# # ### ### 
 # # # # #   # #             # #   #   
 ### ### # ##### ##### ##### # ##### ##
   # #   # # # # #   #   #         # # 
 ### # ### # # # # ### ### # ####### # 
 #     #   #     #   #   # # # #     # 
## ### # ### ##### ##### ### # ### # # 
     # #         #       #       # #   
