 # # #       #       #     # # # #     
 # # # ##### # ####### ### # # # ##### 
         #           #   # #     # # # 
 # ##### # ### # ### # # ### # ### # # 
 # #     # #   # # # # # # # # #       
###### ######### # ### # # # # ##### ##
       #     #         #     # # #     
 # # ####### # ######### ####### # ### 
 # #       #   #     #   # # # # # #   
## # ### ##### ##### ### # # # # ### ##
   # #   # # #         #   #   #   #   
## ### # # # # ### ######### # ### # ##
   # # # #   #   # #     # # #   #     
## # ####### # ### # ##### # ### ##### 
 #     #       #   #         # # # # # 
 ### ####### ### ##### ##### # # # # # 
 #     #     # #           # # #   #   
 ##### # ### # ######### ##### ### # ##
     # # #   #     #   # #   # # #     
## ### # # ### # ##### ##### # # # # ##
       # # #   # #                 # # 
 ##### # ##### # # ##### ########### # 
 # #   # #     #     #   #   #         
 # # # ##### ##### ##### ### ### # ####
 #   # #     #         # # #     #     
###### ##### # ######### # # # ### # ##
     #   #   #   #     # # # #   # #   
 # # # ####### ##### ##### # ####### ##
 # #         # #                   #   
